61202020202020202060
21 0 0 0 0 0 0 0 023
21 0 0 0 0 0 0 0 023
21 0 0 0 0 0 0 0 023
21 0 0 0 0 0 0 0 023
21 0 0 0 0 0 0 0 023
21 0 0 0 0 0 0 0 023
6222222242 043222263
 0 0 0 021 023 0 0 0
 0 0 0 021 023 0 0 0
2020202041 040202020
 0 0 0 0 0 0 0 0 0 0
 0 0 0t0 0 0 0 0 0 0