s0s0s0s0s0s0s0s0s0s0
s0s0s0s0s0s0s0s0s0s0
s0s0s0s0s0s0s0s0s0s0
s0s0s0s0s0s0s0s0s0s0
s0s0s0s0s0s0s0s0s0s0
s0s0s0s0s0s0s0s0s0s0
s0s0s0s0s0s0s0s0s0s0
s0s0s0s0s0s0s0s0s0s0
 0 0 0 0s0s0s0 0 0 0
 0 0 0 0s0s0s0 0 0 0
10101010g0g0g0101010
10101010101010101010
10101010101010101010